11111111111111111
100PC01100C00CC01
1011100C011100001
10000000000000001
1C0000C0000C011E1
1000000C100000001
11111111111111111